1111111111111
1P000000000E1
1011111011111
1C00000000001
1111111111111
