111111111111111
1P0000010000001
101111101111111
1C00000000000C1
101111111111101
1000000000000E1
111111111111111
