1111111111111111111111
1P00000000000000C000C1
1011111110101111111101
1C000000000100000000C1
1110111011101111111111
1C00100C000000000000E1
1111111111111111111111
