1111111111111
1P00000000001
1011111011111
1C000000E00C1
1111111111111
