1111111111111111
1P000000000000C1
1000000000000001
1000000000000001
1000000000000001
1000000000000001
1111111111111111
